Matched Surah Labels (Original -- Matched):
-------------------------------------------
سورة المؤمنون -- المؤمنون
سورة النور -- النور
سورة الفرقان -- الفرقان
سورة الشعراء -- الشعراء
سورة النمل -- النمل
سورة القصص -- القصص
سورة العنكبوت -- العنكبوت
سورة الروم -- الروم
سورة لقمان -- لقمان
سورة السجدة -- السجدة
سورة الأحزاب -- الأحزاب
سورة سبأ -- سبأ
سورة فاطر -- فاطر
سورة يس -- يس
سورة والصافات -- الصافات
سورة {ص} -- ص
سورة الزمر -- الزمر
سورة غافر -- غافر
سورة نوح -- نوح
سورة الجن -- الجن
سورة المزمل -- المزمل
سورة المدثر -- المدثر
سورة القيامة -- القيامة
سورة الإنسان -- الإنسان
سورة المرسلات -- المرسلات
سورة عم يتساءلون -- النبأ
سورة النازعات -- النازعات
سورة عبس -- عبس
سورة إذا الشمس كورت -- التكوير
سورة الانفطار -- الانفطار
سورة ويل للمطففين -- المطففين
سورة إذا السماء انشقت -- الانشقاق
سورة البروج -- البروج
سورة الطارق -- الطارق
سورة سبح -- الأعلى
سورة الغاشية -- الغاشية
سورة والفجر -- الفجر
سورة البلد -- البلد
سورة والشمس وضحاها -- الشمس
سورة والليل -- الليل
سورة والضحى -- الضحى
سورة ألم نشرح -- الشرح
سورة والتين -- التين
سورة اقرأ باسم ربك -- العلق
سورة القدر -- القدر
سورة البينة -- البينة
سورة الزلزلة -- الزلزلة
سورة والعاديات -- العاديات
سورة القارعة -- القارعة
سورة التكاثر -- التكاثر
سورة والعصر -- العصر
سورة الهمزة -- الهمزة
سورة ألم تر -- الفيل
سورة لإيلاف قريش -- قريش
سورة أريت -- الماعون
سورة الكوثر -- الكوثر
سورة قل يا أيها الكافرون -- الكافرون
سورة النصر -- النصر
سورة أبي لهب -- المسد
سورة الإخلاص -- الإخلاص
سورة الفلق -- الفلق
سورة الناس -- الناس

Unmatched Labels (from provided list):
--------------------------------------
