Matched Surah Labels (Original -- Matched):
-------------------------------------------
الفاتحة -- الفاتحة
البقرة -- البقرة
آل عمران -- آل عمران
النساء -- النساء
المائدة -- المائدة
الأنعام -- الأنعام
الأعراف -- الأعراف
الأنفال -- الأنفال
التوبة -- التوبة
يونس -- يونس
هود -- هود
يوسف -- يوسف
الرعد -- الرعد
إبراهيم -- إبراهيم
الحجر -- الحجر
النحل -- النحل
الإسراء -- الإسراء
الكهف -- الكهف
مريم -- مريم
طه -- طه
الأنبياء -- الأنبياء
الحج -- الحج
المؤمنون -- المؤمنون
النور -- النور
الفرقان -- الفرقان
الشعراء -- الشعراء
النمل -- النمل
الشعراء -- الشعراء
النمل -- النمل
القصص -- القصص
العنكبوت -- العنكبوت
الروم -- الروم
لقمان -- لقمان
السجدة -- السجدة
الأحزاب -- الأحزاب
سبأ -- سبأ
فاطر -- فاطر
يس -- يس
الصافات -- الصافات
ص -- ص
الزمر -- الزمر
غافر -- غافر
السجدة -- السجدة
فصلت -- فصلت
الشورى -- الشورى
الزخرف -- الزخرف
الدخان -- الدخان
الجاثية -- الجاثية
الأحقاف -- الأحقاف
محمد -- محمد
الفتح -- الفتح
الحجرات -- الحجرات
ق -- ق
الذاريات -- الذاريات
الطور -- الطور
النجم -- النجم
القمر -- القمر
الرحمن -- الرحمن
الواقعة -- الواقعة
الحديد -- الحديد
المجادلة -- المجادلة
الحشر -- الحشر
الممتحنة -- الممتحنة
الصف -- الصف
الجمعة -- الجمعة
المنافقون -- المنافقون
التغابن -- التغابن
الطلاق -- الطلاق
التحريم -- التحريم
الملك -- الملك
القلم -- القلم
الحاقة -- الحاقة
المعارج -- المعارج
نوح -- نوح
الجن -- الجن
المزمل -- المزمل
المدثر -- المدثر
القيامة -- القيامة
الإنسان -- الإنسان
المرسلات -- المرسلات
النبأ -- النبأ
النازعات -- النازعات
عبس -- عبس
التكوير -- التكوير
الانفطار -- الانفطار
المطففين -- المطففين
الانشقاق -- الانشقاق
البروج -- البروج
الطارق -- الطارق
الأعلى -- الأعلى
الغاشية -- الغاشية
الفجر -- الفجر
البلد -- البلد
الشمس -- الشمس
الليل -- الليل
الضحى -- الضحى
الشرح -- الشرح
التين -- التين
العلق -- العلق
القدر -- القدر
البينة -- البينة
الزلزلة -- الزلزلة
العاديات -- العاديات
القارعة -- القارعة
التكاثر -- التكاثر
العصر -- العصر
الهمزة -- الهمزة
الفيل -- الفيل
قريش -- قريش
الماعون -- الماعون
الكوثر -- الكوثر
الكافرون -- الكافرون
النصر -- النصر
المسد -- المسد
الإخلاص -- الإخلاص
الفلق -- الفلق
الناس -- الناس

Unmatched Labels (from provided list):
--------------------------------------
